##########################
#                        #
#                        #
# |  |                   #
# |  |                   #
#                        # 
#                        #
#                        #
#                        # 
##########     ###########
	     #     #
